akumajou-dracula-x=Akumajou Dracula X (JPN)
albert-odyssey=Albert Odyssey: Legend of Eldean (USA)
alien-trilogy=Alien Trilogy (USA)
assault-suit-leynos-2=Assault Suit Leynos 2 (JPN)
battle-garegga=Battle Garegga (JPN)
bio-hazard=Bio Hazard (JPN)
blast-wind=Blast Wind (JPN)
bulk-slash=Bulk Slash (JPN)
burning-rangers=Burning Rangers (USA)
clockwork-knight=Clockwork Knight: Pepperouchau no Fukubukuro (JPN)
cotton-2=Cotton 2: Magical Night Dreams (JPN)
cotton-boomerang=Cotton Boomerang: Magical Night Dreams (JPN)
courier-crisis=Courier Crisis (USA)
croc=Croc (USA)
cyberbots-full-metal-madness=Cyberbots: Full Metal Madness (JPN)
cyberia=Cyberia (USA)
daytona-usa=Daytona USA (JPN)
daytona-usa-championship-circuit-edition=Daytona USA: Championship Circuit Edition (USA)
dead-or-alive=Dead or Alive (JPN)
death-crimson=Death Crimson (JPN)
elevator-action-returns=Elevator Action Returns (JPN)
fighters-megamix=Fighters Megamix (USA)
fighting-vipers=Fighting Vipers (JPN)
ghen-war=Ghen War (USA)
groove-on-fight=Groove On Fight (JPN)
guardian-heroes=Guardian Heroes (USA)
hang-on-gp-95=Hang On GP '95 (JPN)
hyper-duel=Hyper Duel (JPN)
keio-flying-squadron-2=Keio Flying Squadron 2 (EUR)
layer-section=Layer Section (JPN)
last-bronx=Last Bronx (JPN)
lost-world-jurassic-park=Lost World Jurassic Park (USA)
manx-tt=Manx T.T. (JPN)
marvel-super-heroes-vs-street-fighter=Marvel Super Heroes vs Street Fighter (JPN)
megaman-8=Mega Man 8 (USA)
megaman-x4=Mega Man X4 (USA)
metal-slug=Metal Slug: Super Vehicle-001 (JPN)
mobile-suit-gundam-side-story-1=Mobile Suit Gundam Side Story I (JPN)
mobile-suit-gundam-side-story-2=Mobile Suit Gundam Side Story II (JPN)
mobile-suit-gundam-side-story-3=Mobile Suit Gundam Side Story III (JPN)
nascar-98=NASCAR 98 (USA)
ninpen-manmaru=Ninpen Manmaru (JPN)
panzer-dragoon-saga=Panzer Dragoon Saga (USA)
panzer-dragoon-2-zwei=Panzer Dragoon II Zwei (USA)
policenauts=Policenauts (JPN)
puyo-puyo-sun=Puyo Puyo Sun (JPN)
rabbit=Rabbit (JPN)
radiant-silvergun=Radiant Silvergun (JPN)
rayman=Rayman (USA)
road-rash=Road Rash (USA)
rockman-x4=Rockman X4 (JPN)
sakura-wars=Sakura Wars (JPN)
bomberman=Saturn Bomberman (USA)
bomberman-fight=Saturn Bomberman Fight!! (JPN)
after-burner-2=Sega Ages: After Burner II (JPN)
fantasy-zone=Sega Ages: Fantasy Zone (JPN)
outrun=Sega Ages: OutRun (JPN)
sega-ages-memorial-vol-1=Sega Ages Memorial Selection Vol. 1 (JPN)
sega-ages-memorial-vol-2=Sega Ages Memorial Selection Vol. 2 (JPN)
sega-rally-championship=Sega Rally Championship (JPN)
shadows-of-the-tusk=Shadows of the Tusk (JPN)
shining-force-3=Shining Force 3 (JPN)
shining-the-holy-ark=Shining the Holy Ark (USA)
sonic-jam=Sonic Jam (USA)
sonic-r=Sonic R (USA)
steamgear-mash=Steamgear Mash (JPN)
steep-slope-sliders=Steep Slope Sliders (USA)
stellar-assault-ss=Stellar Assault SS (JPN)
swagman=Swagman (EUR)
three-dirty-dwarves=Three Dirty Dwarves (USA)
thunder-force-gold-pack-2=Thunder Force Gold Pack 2 (JPN)
thunder-force-v=Thunder Force V (JPN)
tokimeki-memorial=Tokimeki Memorial: Forever With You (JPN)
vampire-savior=Vampire Savior (JPN)
virtua-cop=Virtua Cop (JPN)
virtua-cop-2=Virtua Cop 2 (JPN)
virtua-fighter-2=Virtua Fighter 2 (USA)
virtua-fighter-2-jap=Virtua Fighter 2 (JPN)
virtua-fighter-kids=Virtua Fighter Kids (JPN)
x-men-vs-street-fighter=X-Men vs. Street Fighter (JPN)
yumimi-mix-remix=Yumimi Mix Remix (JPN)
